rows 15
cols 20
players 2

m %%%%%%%%%%%%%%%%%%%%
m %%%%%%%%%%%%%%%%%%%%
m %%%%%%%%%%%%%%%%%%%%
m %%%%%..........%%%%%
m %%%%%..........%%%%%
m %%%%%..........%%%%%
m %%%%%**......**%%%%%
m %%%%%B*......*A%%%%%
m %%%%%**......**%%%%%
m %%%%%..........%%%%%
m %%%%%..........%%%%%
m %%%%%..........%%%%%
m %%%%%%%%%%%%%%%%%%%%
m %%%%%%%%%%%%%%%%%%%%
m %%%%%%%%%%%%%%%%%%%%
