rows 34
cols 40
players 2

m %%%%%%%%%%%%%%%%%%%%%%%%%%%%%%%%%%%%%%%%
m %%%%%%%%%%%%%%%%%%%%%%%%%%%%%%%%%%%%%%%%
m %%%%%%%%%%%%%%%%%%%%%%%%%%%%%%%%%%%%%%%%
m %%%%%%%%%%%%%%%%%%%%%%%%%%%%%%%%%%%%%%%%
m %%%%%%%%%%%%%%%%%%%%%%%%%%%%%%%%%%%%%%%%
m %%%%%%%%%%%%%%%%%%%%%%%%%%%%%%%%%%%%%%%%
m %%%%%..............................%%%%%
m %%%%%..............................%%%%%
m %%%%%..............................%%%%%
m %%%%%..............................%%%%%
m %%%%%..............................%%%%%
m %%%%%..............................%%%%%
m %%%%%..............................%%%%%
m %%%%%..............................%%%%%
m %%%%%..............................%%%%%
m %%%%%..............................%%%%%
m %%%%%**..........................**%%%%%
m %%%%%A*..........................*B%%%%%
m %%%%%**..........................**%%%%%
m %%%%%..............................%%%%%
m %%%%%..............................%%%%%
m %%%%%..............................%%%%%
m %%%%%..............................%%%%%
m %%%%%..............................%%%%%
m %%%%%..............................%%%%%
m %%%%%..............................%%%%%
m %%%%%..............................%%%%%
m %%%%%..............................%%%%%
m %%%%%%%%%%%%%%%%%%%%%%%%%%%%%%%%%%%%%%%%
m %%%%%%%%%%%%%%%%%%%%%%%%%%%%%%%%%%%%%%%%
m %%%%%%%%%%%%%%%%%%%%%%%%%%%%%%%%%%%%%%%%
m %%%%%%%%%%%%%%%%%%%%%%%%%%%%%%%%%%%%%%%%
m %%%%%%%%%%%%%%%%%%%%%%%%%%%%%%%%%%%%%%%%
m %%%%%%%%%%%%%%%%%%%%%%%%%%%%%%%%%%%%%%%%
